-                             -
-                             -
-                             -
-                             -
-                             -
-                             -
-                             -
-                             -
-                             -
-             +++             - 
-                             - 
-     +++             +++     -
-              +              - 
-                    j        - 
-                             -
-+++++sss+++++sss+++++sss+++++-
