-                             -
-                             -
-                             -
-                             -
-                             -
-                             -
-                             -
-                             -
- +                         + -
-             +++             - 
-                             - 
-     +++             +++     -
-                             - 
-                    j        - 
-                             -
-++++++++++sss+++sss++++++++++-
