-                             -
-                             -
-                             -
-                             -
-                             -
-                             -
-                             -
-                             -
-                             -
-             +++             - 
-                             - 
-     +++             +++     -
-              +              - 
-                             - 
-                   j         -
-+++++sss+++++sss+++++sss+++++-